WE ../textures/wall_WE.xpm
EA ../textures/wall_EA.xpm

F 188,53,25
NO ../textures/wall_NO.xpm
C 153,204,200

SO ../textures/wall_SO.xpm

         1111111111111111111111111
         1000000000110000000000001
        11011000001110000000000001
       10010000000000000N00000011
111111111011000001110000000000001
         100000000011000001110111111111111
    111111111110111111111011100000010001
11110111111111011101010010001111111111111111
110000001101010111000000100011111111111111111
  1100000000000000011111111100000001
  100000000000000011111111111111111
110000011101010111110111100111
11110111 1110101 101111010001
11111111 1111111 111111111111
