EA ../textures/armenak.xpm
NO ../textures/EA_Wall.xpm

SO ../textures/SO_Wall.xpm
WE ../textures/malena.xpm

F 124,45,12
C 152,100,145

     1111111111
     111100000011111111111111111
      W                 00000111
     11000000111111111111111111111
     10000001
     11111111
