EA ../textures/armenak.xpm
NO ../textures/EA_Wall.xpm

SO ../textures/SO_Wall.xpm
WE ../textures/malena.xpm


F 124,45,12
C 152,100,145














111111
100001
100001
111111

111111
100S01
100001
111111
