NO ../textures/NO_Wall.xpm

SO ../textures/SO_Wall.xpm
WE ../textures/EA_Wall.xpm
EA ../textures/WE_Wall.xpm

F 124,45,12
C 152,100,124

11111111111111111111111111111111111111111111111111111111111111111111111111111111
10100000000000000000000000000000000000000000000000000000000000000000000000000001
10001111111111111100111111111111111111001111111111111111101011111111111111111101
11011000100011111110000000001000000001000000001110000000100000000000000000000001
11011010101011000011111111001000110000111111000000011100010000000001111100000111
11010010001000010001000000000000100110100001111111111100111111000111111111111111
11010111111100111101111111111111111110101100011110000000100011011111111111111111
1000000000010000010000000000000000001000011000000011110000100111           11111
10111111111111100111100011111001111111111111111111111111111111               111
10010001000001100111111111111111111111    1111111111111111111   1  1   111    11
1001110101110110011111111111111111            11111111111111   1   1  1   1    1
1000010101110110011111111111111                  11111111111  111111    11     1
101001010001011001111111111                          1111111       1   1       1
10100001110101100111111W                                11111     111 11111   11
10111111110100100111                                        11               111
101    1110100100111                                          111         111111
101    1110111100111                                             111   111111111
101    111011 100111                                                111111111111
10111111110111101111                                                  1111111111
1011111110001100110011                                                  11111111
10000000000110010001111                                                   111111
10111111001000100100001                                                  1111111
1011111110010000100001                                                  11111111
101001101100111000101                                                  111111111
10000110111001111111                                                  1111111111
11100110111111                                                       11111111111
1010011011111                                                       111111111111
10100000111111                                                     1111111111111
101000001111111                                                   11111111111111
1011110011111111                                                 111111111111111
10001100111111111                                               1111111111111111
100000001111111111                                             11111111111111111
1111111111111111111                                           111111111111111111
11111111111111111111                                         1111111111111111111
111111111111111111111                                       11111111111111111111
1111111111111111111111                                     111111111111111111111
11111111111111111111111                                   1111111111111111111111
111111111111111111111111                                 11111111111111111111111
1111111111111111111111111                               111111111111111111111111
11111111111111111111111111                             1111111111111111111111111
111111111111111111111111111                           11111111111111111111111111
1111111111111111111111111111                         111111111111111111111111111
11111111111111111111111111111                       1111111111111111111111111111
111111111111111111111111111111                     11111111111111111111111111111
1111111111111111111111111111111                   111111111111111111111111111111
11111111111111111111111111111111                 1111111111111111111111111111111
1111111111111111111111111111111111             111111111111111111111111111111111
11111111111111111111111111111111111           1111111111111111111111111111111111
111111111111111111111111111111111111         11111111111111111111111111111111111
1111111111111111111111111111111111111       111111111111111111111111111111111111
11111111111111111111111111111111111111     1111111111111111111111111111111111111
111111111111111111111111111111111111111   11111111111111111111111111111111111111
1111111111111111111111111111111111111111 111111111111111111111111111111111111111
11111111111111111111111111111111111111111111111111111111111111111111111111111111
11111111111111111111111111111111111111111111111111111111111111111111111111111111
11111111111111111111111111111111111111111111111111111111111111111111111111111111
11111111111111111111111111111111111111111111111111111111111111111111111111111111
11111111111111111111111111111111111111111111111111111111111111111111111111111111
11111111111111111111111111111111111111111111111111111111111111111111111111111111
11111111111111111111111111111111111111111111111111111111111111111111111111111111
11111111111111111111111111111111111111111111111111111111111111111111111111111111
11111111111111111111111111111111111111111111111111111111111111111111111111111111
11111111111111111111111111111111111111111111111111111111111111111111111111111111
11111111111111111111111111111111111111111111111111111111111111111111111111111111
