EA ../textures/armenak.xpm
NO ../textures/EA_Wall.xpm

SO ../textures/SO_Wall.xpm
WE ../textures/malena.xpm

F 124,45,12
C 152,100,145

1111111
 1000001
  10W0001
 1000011
1111111