NO ../textures/wall_NO.xpm

SO ../textures/wall_SO.xpm
WE ../textures/wall_WE.xpm
EA ../textures/wall_EA.xpm

F 18,53,25
C 153,204,255

111  111
1001 10011
1000100001
1W0   111
10 0001
1000011
111111
