NO ./textures/T_128_N.xpm
SO ./textures/T_128_S.xpm
WE ./textures/T_128_W.xpm
EA ./textures/T_128_E.xpm

F 18,53,25
C 153,204,255


11111
10001
10001
10N01
10001
10001
11111


|1|1|1|1|1|
|1|_|_|_|1|
|1|_|_|_|1|
|1|_|X|_|1|
|1|_|_|_|1|
|1|_|_|_|1|
|1|1|1|1|1|