EA ../textures/armenak.xpm
NO ../textures/EA_Wall.xpm

SO ../textures/SO_Wall.xpm
WE ../textures/malena.xpm

F 124,45,12
C 152,100,145

     11111111111
     1111000000011111111111111111
	 1                    000W000111
     110000000111111111111111111111
     100000001
     111111111
