EA ../textures/armenak.xpm
NO ../textures/EA_Wall.xpm

SO ../textures/SO_Wall.xpm
WE ../textures/malena.xpm

F 124,45,12
C 152,100,145

            1111111
            111 1
            1  11
            1W00011
            11111111