EA ../textures/armenak.xpm
NO ../textures/EA_Wall.xpm

SO ../textures/SO_Wall.xpm
WE ../textures/malena.xpm

F 124,45,12
C 152,100,124

111  111111111111111
100000000000000001
100010000000010001
100000000000000001
10000000W000000001
100000000000000001
100010000000010001
100000000000000001
111111111111111111
